####################
#                  #
#                  #
#          r       #
#                  #
#                  #
#         g|||g    #
#         ,   -    #
#         ,   -    #
#         ,   -    #
#         g...g    #
#                  #
#                  #
#                  #
#                  #
#  gggggggggggggg  #
#  ,,,,,,,,,,,,,,  #
#  gggggggggggggg  #
#  --------------  #
####################
